1111111111111111111111111
10000P000CC0CCC0000000C11
1000000H00CC0000000000C11
1C001H1111111000000111111
11CH00111111100001CE00011
100000000000000001CHCH011
1110000000111111111111111
1110000000111111111111111
1110000000111111111111111
1110000000111111111111111
1110000000111111111111111
1110000000111111111111111
1110000000111111111111111
1110000000111111111111111
1110000000111111111111111
1110000000111111111111111
1100000000000000000000011
1111111111111111111111111