11111111111111111111111111111
11111P000CC1CCC0H00000CCCCC01
1000000H00CC0000000000CCCCC11
1C001H111111100000H11110H0001
11CH00111111100001CE000011111
100000000000000001CHCH0011111
11111111111111111111111111111